appid,num_reviews,review_score,review_score_desc,total_positive,total_negative,total_reviews
730,100,8,Very Positive,2065158,315474,2380632
570,100,8,Very Positive,699249,92354,791603
578080,100,5,Mixed,283362,148504,431866
252490,100,8,Very Positive,509838,78944,588782
359550,100,8,Very Positive,597622,118685,716307
431960,100,9,Overwhelmingly Positive,225177,4214,229391
413150,100,9,Overwhelmingly Positive,419519,4866,424385
218,0,0,No user reviews,0,0,0
381210,100,6,Mostly Positive,258497,65104,323601
440,100,8,Very Positive,627415,78538,705953
251570,100,8,Very Positive,150098,22746,172844
238960,100,8,Very Positive,121462,15627,137089
230410,100,8,Very Positive,249435,22768,272203
271590,100,8,Very Positive,523200,105142,628342
236390,100,6,Mostly Positive,201761,68269,270030
438100,100,6,Mostly Positive,116975,45809,162784
553850,100,8,Very Positive,617537,122617,740154
550,100,9,Overwhelmingly Positive,289224,7641,296865
480,0,0,No user reviews,0,0,0
221100,100,6,Mostly Positive,145215,53628,198843
105600,100,9,Overwhelmingly Positive,674574,16918,691492
289070,100,8,Very Positive,120569,22331,142900
394360,100,8,Very Positive,135430,13312,148742
294100,100,9,Overwhelmingly Positive,126421,2529,128950
322330,100,9,Overwhelmingly Positive,119308,5730,125038
108600,100,8,Very Positive,159986,10408,170394
322170,100,8,Very Positive,189981,13142,203123
346110,100,8,Very Positive,258531,63535,322066
218620,100,8,Very Positive,230853,33797,264650
252950,100,8,Very Positive,258584,40527,299111
261550,100,8,Very Positive,92424,13836,106260
39210,100,8,Very Positive,55261,7356,62617
4000,100,9,Overwhelmingly Positive,559865,17657,577522
250900,100,9,Overwhelmingly Positive,138783,4003,142786
513710,100,6,Mostly Positive,32744,11669,44413
489830,100,8,Very Positive,185675,16210,201885
582660,100,6,Mostly Positive,35011,14122,49133
526870,100,9,Overwhelmingly Positive,135683,3576,139259
646570,100,9,Overwhelmingly Positive,78861,1854,80715
240,100,9,Overwhelmingly Positive,60678,2506,63184
284160,100,9,Overwhelmingly Positive,179531,4400,183931
427520,100,9,Overwhelmingly Positive,131437,2394,133831
304930,100,8,Very Positive,198914,19938,218852
291550,100,6,Mostly Positive,132918,33362,166280
8930,100,9,Overwhelmingly Positive,121145,5647,126792
281990,100,8,Very Positive,86024,12728,98752
377160,100,8,Very Positive,197761,42364,240125
216150,100,5,Mixed,7635,4658,12293
629520,100,9,Overwhelmingly Positive,27504,1245,28749
227300,100,9,Overwhelmingly Positive,163753,4111,167864
582010,100,8,Very Positive,151527,13326,164853
242760,100,9,Overwhelmingly Positive,193938,9567,203505
457140,100,9,Overwhelmingly Positive,46633,1976,48609
306130,100,8,Very Positive,68034,15999,84033
594650,100,6,Mostly Positive,84833,27731,112564
529340,100,5,Mixed,17044,8275,25319
236850,100,8,Very Positive,58478,8676,67154
292030,100,9,Overwhelmingly Positive,235108,7690,242798
270880,100,9,Overwhelmingly Positive,95673,2790,98463
286160,100,9,Overwhelmingly Positive,43799,1671,45470
275850,100,8,Very Positive,167795,37876,205671
367520,100,9,Overwhelmingly Positive,150873,4618,155491
107410,100,8,Very Positive,122656,11609,134265
393380,100,8,Very Positive,88114,16351,104465
365670,100,9,Overwhelmingly Positive,33850,1303,35153
255710,100,8,Very Positive,114557,8780,123337
648800,100,8,Very Positive,133933,8915,142848
632360,100,8,Very Positive,205220,11581,216801
244210,100,8,Very Positive,62701,4676,67377
397540,100,8,Very Positive,59113,14388,73501
548430,100,9,Overwhelmingly Positive,198317,4643,202960
311210,100,8,Very Positive,134234,19895,154129
239140,100,8,Very Positive,118387,7058,125445
376210,100,6,Mostly Positive,42570,11654,54224
552990,100,8,Very Positive,37121,9051,46172
613100,100,8,Very Positive,45901,2751,48652
49520,100,8,Very Positive,156845,17672,174517
544810,100,8,Very Positive,8075,1757,9832
714010,100,8,Very Positive,57419,5114,62533
10,100,9,Overwhelmingly Positive,57951,1609,59560
431730,100,9,Overwhelmingly Positive,13723,113,13836
232090,100,8,Very Positive,53868,7836,61704
700330,100,8,Very Positive,81024,6509,87533
518790,100,8,Very Positive,59102,6927,66029
22380,100,9,Overwhelmingly Positive,175879,6737,182616
440900,100,6,Mostly Positive,41877,11162,53039
233860,100,9,Overwhelmingly Positive,47676,2425,50101
374320,100,8,Very Positive,149453,9666,159119
391540,100,9,Overwhelmingly Positive,156591,5701,162292
534380,100,6,Mostly Positive,62711,18176,80887
220200,100,9,Overwhelmingly Positive,83942,3985,87927
214950,100,8,Very Positive,38279,6870,45149
359320,100,6,Mostly Positive,50918,14863,65781
244850,100,8,Very Positive,75483,9273,84756
264710,100,9,Overwhelmingly Positive,174535,5765,180300
435150,100,9,Overwhelmingly Positive,85876,4008,89884
728880,100,8,Very Positive,16480,1069,17549
686810,100,8,Very Positive,67946,14775,82721
8500,100,6,Mostly Positive,15734,5832,21566
444200,100,6,Mostly Positive,17404,5802,23206
505460,100,8,Very Positive,23336,4928,28264
568220,100,8,Very Positive,10933,836,11769
268500,100,8,Very Positive,49536,8792,58328
262060,100,8,Very Positive,56546,5657,62203
380600,100,8,Very Positive,21216,4008,25224
219990,100,9,Overwhelmingly Positive,43806,2305,46111
627690,100,6,Mostly Positive,7145,2150,9295
48700,100,9,Overwhelmingly Positive,65829,1597,67426
304390,100,5,Mixed,52766,23363,76129
268910,100,9,Overwhelmingly Positive,64060,2600,66660
12210,100,8,Very Positive,57646,14223,71869
379430,100,8,Very Positive,62028,11970,73998
4700,100,9,Overwhelmingly Positive,19394,863,20257
655500,100,8,Very Positive,19820,1181,21001
570940,100,8,Very Positive,54958,4822,59780
602960,100,8,Very Positive,35069,1945,37014
3590,100,9,Overwhelmingly Positive,40846,789,41635
588650,100,9,Overwhelmingly Positive,46510,1717,48227
400750,100,8,Very Positive,8713,1587,10300
221380,100,9,Overwhelmingly Positive,42410,2120,44530
703080,100,8,Very Positive,41438,4033,45471
400040,100,9,Overwhelmingly Positive,2412,123,2535
361420,100,8,Very Positive,54598,4897,59495
371970,100,8,Very Positive,9009,769,9778
362890,100,8,Very Positive,66434,3498,69932
644930,100,8,Very Positive,16489,4010,20499
32470,100,9,Overwhelmingly Positive,27839,672,28511
669330,100,8,Very Positive,7559,1171,8730
552520,100,8,Very Positive,57005,13694,70699
504230,100,9,Overwhelmingly Positive,57256,1527,58783
287700,100,8,Very Positive,52374,4840,57214
386360,100,6,Mostly Positive,52350,15593,67943
34330,100,8,Very Positive,31008,2547,33555
632470,100,8,Very Positive,52039,4104,56143
620,100,9,Overwhelmingly Positive,194733,2344,197077
601150,100,9,Overwhelmingly Positive,44067,2253,46320
231430,100,8,Very Positive,35477,7413,42890
10500,100,8,Very Positive,18431,1930,20361
305620,100,8,Very Positive,37765,4826,42591
427410,100,9,Overwhelmingly Positive,20679,615,21294
208650,100,8,Very Positive,57556,8927,66483
431240,100,8,Very Positive,44123,5648,49771
363970,100,8,Very Positive,24969,3287,28256
508440,100,9,Overwhelmingly Positive,80015,1627,81642
356190,100,8,Very Positive,40154,5565,45719
581320,100,8,Very Positive,61457,10238,71695
418370,100,8,Very Positive,34191,2050,36241
495420,100,8,Very Positive,19675,3366,23041
392160,100,6,Mostly Positive,10430,2815,13245
601510,100,8,Very Positive,16379,3502,19881
433340,100,9,Overwhelmingly Positive,69099,1367,70466
200210,100,8,Very Positive,26018,6082,32100
731490,100,8,Very Positive,8387,924,9311
699130,100,8,Very Positive,6749,1191,7940
220,100,9,Overwhelmingly Positive,108288,2998,111286
219740,100,9,Overwhelmingly Positive,38340,1469,39809
663090,54,5,Mixed,422,216,638
573090,100,8,Very Positive,36369,4114,40483
460930,100,6,Mostly Positive,31923,8175,40098
21690,100,8,Very Positive,16423,3106,19529
335300,100,8,Very Positive,39362,8532,47894
389430,90,4,Mostly Negative,631,1103,1734
346010,100,9,Overwhelmingly Positive,23424,1213,24637
323190,100,8,Very Positive,40373,3169,43542
466560,100,8,Very Positive,23903,4226,28129
635260,100,9,Overwhelmingly Positive,38685,1926,40611
47890,100,8,Very Positive,18987,2727,21714
632810,100,8,Very Positive,145,13,158
8800,100,9,Overwhelmingly Positive,3274,128,3402
3910,100,8,Very Positive,4418,458,4876
379720,100,9,Overwhelmingly Positive,109179,5062,114241
552500,100,8,Very Positive,57233,6685,63918
471710,100,8,Very Positive,47746,6068,53814
701160,100,8,Very Positive,10262,1226,11488
594570,100,8,Very Positive,63492,4466,67958
637090,100,8,Very Positive,21526,3717,25243
477160,100,9,Overwhelmingly Positive,40606,2079,42685
325610,100,6,Mostly Positive,13748,3533,17281
212680,100,9,Overwhelmingly Positive,54574,2398,56972
582160,100,8,Very Positive,29228,5559,34787
221040,100,6,Mostly Positive,12392,4830,17222
311690,100,9,Overwhelmingly Positive,40859,1960,42819
203770,100,8,Very Positive,42883,4222,47105
414700,100,8,Very Positive,10512,1774,12286
493520,100,8,Very Positive,29767,5124,34891
204360,100,9,Overwhelmingly Positive,51790,1730,53520
524220,100,8,Very Positive,53525,5973,59498
254700,100,8,Very Positive,27072,2095,29167
412830,100,9,Overwhelmingly Positive,4605,216,4821
391220,100,8,Very Positive,34132,2872,37004
282070,100,8,Very Positive,24544,2071,26615
359870,100,8,Very Positive,10403,1119,11522
466170,100,8,Very Positive,1293,228,1521
312520,100,8,Very Positive,28352,1597,29949
211820,100,8,Very Positive,65488,8514,74002
365360,100,8,Very Positive,13021,1569,14590
1840,100,8,Very Positive,26177,2012,28189
412220,100,8,Very Positive,2179,243,2422
665300,100,9,Overwhelmingly Positive,1225,64,1289
298110,100,8,Very Positive,19005,4459,23464
386940,100,9,Overwhelmingly Positive,17704,635,18339
459820,100,8,Very Positive,16745,1960,18705
346900,100,8,Very Positive,32483,5160,37643
234140,100,8,Very Positive,35200,3194,38394
297000,100,6,Mostly Positive,5792,1737,7529
203160,100,8,Very Positive,70335,4279,74614
588430,100,8,Very Positive,25603,4155,29758
72850,100,8,Very Positive,161462,12036,173498
585420,100,8,Very Positive,18082,1433,19515
70,99,9,Overwhelmingly Positive,70136,2566,72702
9900,100,6,Mostly Positive,12648,3308,15956
404790,100,9,Overwhelmingly Positive,3763,167,3930
223750,100,8,Very Positive,18070,3237,21307
233450,100,8,Very Positive,35726,4522,40248
215360,0,0,No user reviews,0,0,0
502500,100,8,Very Positive,20958,2692,23650
690830,100,8,Very Positive,8586,1464,10050
424030,100,8,Very Positive,9953,1272,11225
269210,100,5,Mixed,9536,6173,15709
571740,100,8,Very Positive,12961,1513,14474
447040,100,8,Very Positive,19949,4239,24188
599140,100,8,Very Positive,17073,3255,20328
242050,100,8,Very Positive,26582,4151,30733
34030,100,8,Very Positive,12610,1257,13867
516750,100,8,Very Positive,31605,2340,33945
228200,100,8,Very Positive,6996,395,7391
500,100,9,Overwhelmingly Positive,21868,1016,22884
41005,0,0,No user reviews,0,0,0
489630,100,8,Very Positive,6852,1699,8551
386180,100,5,Mixed,14519,6616,21135
212200,100,6,Mostly Positive,2857,990,3847
200260,100,9,Overwhelmingly Positive,31471,1272,32743
304050,100,6,Mostly Positive,32517,9634,42151
17390,100,8,Very Positive,35672,2891,38563
220240,100,8,Very Positive,36503,6146,42649
335240,100,8,Very Positive,7251,1213,8464
719890,100,5,Mixed,3687,1728,5415
225540,100,8,Very Positive,47029,8512,55541
363890,100,8,Very Positive,3923,436,4359
357070,100,8,Very Positive,1330,157,1487
552100,100,8,Very Positive,25795,1438,27233
387990,100,8,Very Positive,45490,4449,49939
683320,100,9,Overwhelmingly Positive,27417,1420,28837
454650,100,8,Very Positive,20488,2470,22958
266840,100,8,Very Positive,14608,1324,15932
312060,100,5,Mixed,581,355,936
1273,0,0,No user reviews,0,0,0
383120,100,6,Mostly Positive,16202,4338,20540
544730,100,5,Mixed,4993,5464,10457
212500,100,8,Very Positive,10776,2498,13274
628070,39,8,Very Positive,214,34,248
307690,100,9,Overwhelmingly Positive,28579,1379,29958
35140,100,9,Overwhelmingly Positive,35071,1276,36347
535930,100,8,Very Positive,14729,1258,15987
246620,100,8,Very Positive,24788,1586,26374
312660,100,8,Very Positive,16408,1684,18092
670290,100,6,Mostly Positive,2550,930,3480
209000,100,8,Very Positive,23985,3235,27220
636480,100,9,Overwhelmingly Positive,43562,1162,44724
444090,100,8,Very Positive,104551,22908,127459
286690,100,8,Very Positive,26973,3651,30624
702320,75,5,Mixed,380,246,626
493340,100,8,Very Positive,33500,3305,36805
293760,100,8,Very Positive,10245,741,10986
289650,100,6,Mostly Positive,18856,6094,24950
221680,100,8,Very Positive,15296,2124,17420
212910,100,9,Overwhelmingly Positive,12550,557,13107
332850,0,0,No user reviews,0,0,0
445220,100,8,Very Positive,7651,878,8529
287450,100,8,Very Positive,8365,461,8826
329110,100,6,Mostly Positive,3527,1130,4657
239030,100,9,Overwhelmingly Positive,40160,1164,41324
400,100,9,Overwhelmingly Positive,88653,1235,89888
244450,100,8,Very Positive,18490,1765,20255
729040,100,6,Mostly Positive,13450,3680,17130
280680,100,9,Overwhelmingly Positive,2528,90,2618
436150,100,5,Mixed,4068,2200,6268
433850,100,5,Mixed,28770,28462,57232
3330,100,9,Overwhelmingly Positive,2256,113,2369
492720,100,8,Very Positive,10962,1733,12695
218230,100,8,Very Positive,38396,8507,46903
678950,100,8,Very Positive,31909,3199,35108
377840,100,8,Very Positive,6623,394,7017
223250,0,0,No user reviews,0,0,0
241930,100,8,Very Positive,42825,3786,46611
3900,100,8,Very Positive,2176,172,2348
485510,100,8,Very Positive,8719,1859,10578
223850,100,8,Very Positive,7827,637,8464
412020,100,8,Very Positive,32192,4878,37070
9420,100,9,Overwhelmingly Positive,8133,260,8393
551170,91,8,Very Positive,1532,264,1796
668580,100,6,Mostly Positive,10929,2786,13715
444490,3,6,Mostly Positive,148,63,211
625960,100,6,Mostly Positive,7668,2718,10386
22330,100,9,Overwhelmingly Positive,36251,1612,37863
39140,100,8,Very Positive,16282,1484,17766
349040,100,8,Very Positive,18839,1942,20781
388080,100,8,Very Positive,2400,501,2901
261640,100,6,Mostly Positive,18900,6163,25063
223470,100,9,Overwhelmingly Positive,44733,1328,46061
638970,100,9,Overwhelmingly Positive,44246,1448,45694
96810,0,0,No user reviews,0,0,0
704450,100,8,Very Positive,5419,519,5938
629760,100,8,Very Positive,58260,13594,71854
646910,100,6,Mostly Positive,22560,7141,29701
424840,100,8,Very Positive,32239,1984,34223
636150,83,8,Very Positive,367,72,439
383980,100,9,Overwhelmingly Positive,29187,1213,30400
360430,100,5,Mixed,13538,9373,22911
527230,100,8,Very Positive,14462,1685,16147
568880,0,0,No user reviews,0,0,0
72780,0,0,No user reviews,0,0,0
200510,100,8,Very Positive,32110,2453,34563
4940,0,0,No user reviews,0,0,0
629730,100,9,Overwhelmingly Positive,47455,1528,48983
469600,100,8,Very Positive,6217,967,7184
637650,100,8,Very Positive,17292,3644,20936
9450,100,9,Overwhelmingly Positive,9706,507,10213
109600,100,6,Mostly Positive,13824,4636,18460
8710,0,0,No user reviews,0,0,0
458750,100,8,Very Positive,497,42,539
42700,100,8,Very Positive,21295,2432,23727
247080,100,9,Overwhelmingly Positive,13176,583,13759
342200,100,8,Very Positive,7906,1842,9748
243470,100,6,Mostly Positive,13611,4794,18405
438040,100,8,Very Positive,5354,978,6332
307780,100,6,Mostly Positive,14842,4530,19372
285900,100,8,Very Positive,24036,4401,28437
24200,100,6,Mostly Positive,9580,2537,12117
268850,100,6,Mostly Positive,2722,715,3437
255300,24,8,Very Positive,498,100,598
40970,100,9,Overwhelmingly Positive,6812,194,7006
704850,100,8,Very Positive,9870,1330,11200
304240,100,8,Very Positive,12002,1209,13211
407230,14,5,Mixed,198,105,303
4760,100,8,Very Positive,10236,562,10798
389730,100,8,Very Positive,38524,4075,42599
32440,100,9,Overwhelmingly Positive,16036,571,16607
475150,100,8,Very Positive,9691,1199,10890
690790,100,8,Very Positive,19207,2609,21816
205710,100,8,Very Positive,1796,395,2191
674940,100,8,Very Positive,61550,3832,65382
244310,0,0,No user reviews,0,0,0
242920,100,8,Very Positive,25921,2801,28722
208580,100,8,Very Positive,18148,1177,19325
333640,100,9,Overwhelmingly Positive,9194,470,9664
470220,100,6,Mostly Positive,23865,9263,33128
365590,100,6,Mostly Positive,22396,8885,31281
494840,100,8,Very Positive,9294,1584,10878
111710,0,0,No user reviews,0,0,0
19680,100,8,Very Positive,9255,1163,10418
238320,100,9,Overwhelmingly Positive,35097,1605,36702
610080,100,8,Very Positive,3398,517,3915
314160,100,8,Very Positive,13533,2127,15660
201810,100,8,Very Positive,28422,3079,31501
671860,100,8,Very Positive,72829,14482,87311
631510,100,8,Very Positive,8035,572,8607
266410,100,8,Very Positive,2755,506,3261
619820,100,8,Very Positive,3046,507,3553
371660,100,8,Very Positive,10705,1837,12542
205100,100,9,Overwhelmingly Positive,46595,1196,47791
666140,100,8,Very Positive,14265,1280,15545
47810,100,8,Very Positive,18182,2864,21046
213670,100,9,Overwhelmingly Positive,33776,1015,34791
2403,0,0,No user reviews,0,0,0
502520,100,8,Very Positive,4838,611,5449
640820,100,6,Mostly Positive,16381,5006,21387
678960,100,8,Very Positive,20728,3109,23837
337410,21,5,Mixed,47,51,98
464920,100,8,Very Positive,12146,2548,14694
463530,100,9,Overwhelmingly Positive,9320,426,9746
698780,100,9,Overwhelmingly Positive,117186,4199,121385
42960,100,8,Very Positive,10167,813,10980
589290,100,8,Very Positive,16230,1693,17923
249130,100,8,Very Positive,9174,583,9757
78000,100,9,Overwhelmingly Positive,4448,209,4657
434170,100,9,Overwhelmingly Positive,5231,147,5378
692890,100,9,Overwhelmingly Positive,15081,629,15710
16900,100,8,Very Positive,13411,1649,15060
368260,100,8,Very Positive,12124,2634,14758
20900,100,8,Very Positive,17760,2998,20758
10090,100,8,Very Positive,34370,2924,37294
373420,100,8,Very Positive,11478,1614,13092
228280,100,8,Very Positive,9403,792,10195
17585,0,0,No user reviews,0,0,0
640380,75,8,Very Positive,269,17,286
337320,100,9,Overwhelmingly Positive,13644,635,14279
211,0,0,No user reviews,0,0,0
410900,100,8,Very Positive,8694,731,9425
22320,100,9,Overwhelmingly Positive,20125,896,21021
33230,100,8,Very Positive,14851,2391,17242
211500,100,6,Mostly Positive,7358,2642,10000
8770,0,0,No user reviews,0,0,0
292120,100,6,Mostly Positive,7791,2623,10414
32370,100,8,Very Positive,22670,2151,24821
230290,100,9,Overwhelmingly Positive,19249,678,19927
367500,100,8,Very Positive,24265,3120,27385
418460,100,8,Very Positive,31984,4361,36345
382310,100,6,Mostly Positive,6237,1614,7851
208050,0,0,No user reviews,0,0,0
243750,0,0,No user reviews,0,0,0
12200,100,8,Very Positive,12477,2987,15464
418530,100,8,Very Positive,14048,1040,15088
269950,100,8,Very Positive,8211,716,8927
409710,100,8,Very Positive,24101,5976,30077
302550,0,0,No user reviews,0,0,0
65800,100,8,Very Positive,12317,955,13272
2145,0,0,No user reviews,0,0,0
597180,100,8,Very Positive,2705,502,3207
403640,100,8,Very Positive,24561,3546,28107
273110,100,5,Mixed,8912,6121,15033
268650,100,8,Very Positive,9412,1122,10534
595520,100,8,Very Positive,4658,527,5185
24780,100,8,Very Positive,4709,1042,5751
34120,0,0,No user reviews,0,0,0
252410,100,8,Very Positive,4302,338,4640
224260,100,8,Very Positive,26704,3281,29985
206480,100,6,Mostly Positive,4043,1606,5649
285920,100,8,Very Positive,13775,1260,15035
612880,100,6,Mostly Positive,17647,5029,22676
17505,0,0,No user reviews,0,0,0
235460,100,9,Overwhelmingly Positive,45710,1965,47675
240720,100,8,Very Positive,36325,6815,43140
311310,100,5,Mixed,4030,3737,7767
564,0,0,No user reviews,0,0,0
230030,0,0,No user reviews,0,0,0
43210,0,0,No user reviews,0,0,0
453480,100,6,Mostly Positive,5499,1639,7138
22370,100,8,Very Positive,28286,6783,35069
203140,100,8,Very Positive,14862,2155,17017
90,0,0,No user reviews,0,0,0
508290,15,4,Mostly Negative,129,230,359
673950,100,8,Very Positive,5602,411,6013
392110,100,8,Very Positive,9941,2182,12123
611150,100,8,Very Positive,464,1,465
42750,0,0,No user reviews,0,0,0
512900,100,9,Overwhelmingly Positive,10578,394,10972
394690,100,8,Very Positive,12499,1351,13850
223240,0,0,No user reviews,0,0,0
223710,100,8,Very Positive,30364,4136,34500
363150,51,5,Mixed,630,302,932
251060,100,8,Very Positive,8568,1172,9740
70010,0,0,No user reviews,0,0,0
586140,100,9,Overwhelmingly Positive,5589,287,5876
253710,100,5,Mixed,9987,8314,18301
10180,100,8,Very Positive,24097,2353,26450
17575,0,0,No user reviews,0,0,0
3480,100,9,Overwhelmingly Positive,9548,247,9795
245170,100,8,Very Positive,14855,2436,17291
635,0,0,No user reviews,0,0,0
274170,100,8,Very Positive,23957,2076,26033
257350,100,8,Very Positive,5641,489,6130
641990,100,8,Very Positive,12036,1255,13291
620980,100,9,Overwhelmingly Positive,54464,2341,56805
246900,100,8,Very Positive,12425,942,13367
24010,100,6,Mostly Positive,10471,4310,14781
2280,100,9,Overwhelmingly Positive,16799,682,17481
17480,100,8,Very Positive,4931,963,5894
251670,100,6,Mostly Positive,692,281,973
207610,100,9,Overwhelmingly Positive,33045,1071,34116
648350,100,8,Very Positive,22601,3481,26082
603850,100,8,Very Positive,7932,1223,9155
91720,0,0,No user reviews,0,0,0
361280,100,8,Very Positive,5690,471,6161
17515,0,0,No user reviews,0,0,0
740,0,0,No user reviews,0,0,0
228180,96,8,Very Positive,1487,358,1845
55280,0,0,No user reviews,0,0,0
6060,100,9,Overwhelmingly Positive,37785,1974,39759
488790,100,8,Very Positive,13370,2837,16207
490110,100,8,Very Positive,2793,376,3169
597170,100,9,Overwhelmingly Positive,17068,484,17552
327030,100,8,Very Positive,4895,1005,5900
718670,100,6,Mostly Positive,5469,1721,7190
80,100,8,Very Positive,8616,748,9364
313120,100,6,Mostly Positive,18210,6487,24697
578650,100,8,Very Positive,15065,3153,18218
364360,100,8,Very Positive,22971,5209,28180
423230,100,8,Very Positive,7509,727,8236
8870,100,8,Very Positive,57721,5552,63273
486150,7,5,Mixed,24,35,59
329000,5,5,Mixed,23,30,53
24810,100,8,Very Positive,2484,143,2627
204100,100,8,Very Positive,22214,4044,26258
237310,100,6,Mostly Positive,4544,1811,6355
287390,100,8,Very Positive,18499,2576,21075
248390,100,8,Very Positive,4154,902,5056
339800,100,9,Overwhelmingly Positive,24954,1081,26035
228380,100,8,Very Positive,20183,2850,23033
20920,100,8,Very Positive,24676,3263,27939
546560,100,9,Overwhelmingly Positive,65652,1176,66828
236110,100,6,Mostly Positive,9745,3421,13166
410340,100,9,Overwhelmingly Positive,5682,297,5979
354290,47,6,Mostly Positive,626,232,858
252610,100,8,Very Positive,6443,366,6809
387290,100,8,Very Positive,30885,1874,32759
65980,100,5,Mixed,8981,6712,15693
413410,100,9,Overwhelmingly Positive,15249,703,15952
527430,100,6,Mostly Positive,8751,2447,11198
274190,100,9,Overwhelmingly Positive,24219,885,25104
648100,100,8,Very Positive,668,67,735
480490,100,8,Very Positive,26660,2396,29056
63220,0,0,No user reviews,0,0,0
383150,100,8,Very Positive,8432,1968,10400
292730,100,5,Mixed,8778,6181,14959
341310,24,6,Mostly Positive,677,246,923
219150,100,9,Overwhelmingly Positive,44203,1536,45739
212542,0,0,No user reviews,0,0,0
397900,100,5,Mixed,9687,7463,17150
202990,100,8,Very Positive,6295,581,6876
423710,4,4,Mostly Negative,57,88,145
298050,100,6,Mostly Positive,3826,1213,5039
621060,100,8,Very Positive,22629,1435,24064
413420,100,9,Overwhelmingly Positive,11818,491,12309
517630,100,5,Mixed,8347,5604,13951
310950,100,5,Mixed,13160,6908,20068
231120,100,8,Very Positive,227,13,240
382030,0,0,No user reviews,0,0,0
588030,100,9,Overwhelmingly Positive,5159,204,5363
282440,100,8,Very Positive,7375,1381,8756
202970,100,8,Very Positive,18829,3392,22221
214490,100,8,Very Positive,31108,2530,33638
213610,100,8,Very Positive,17331,2058,19389
326460,100,8,Very Positive,19044,1397,20441
569480,100,8,Very Positive,18101,1220,19321
45760,100,8,Very Positive,6702,870,7572
368500,100,6,Mostly Positive,7554,2044,9598
48190,100,8,Very Positive,7462,1169,8631
220700,99,8,Very Positive,3082,211,3293
339600,88,5,Mixed,1120,1079,2199
621830,100,6,Mostly Positive,1343,457,1800
204880,100,8,Very Positive,10269,618,10887
292000,100,5,Mixed,4562,3839,8401
42680,100,8,Very Positive,13013,1933,14946
110800,100,8,Very Positive,14702,2850,17552
589590,100,9,Overwhelmingly Positive,6948,218,7166
203300,0,0,No user reviews,0,0,0
450540,100,9,Overwhelmingly Positive,18923,568,19491
47410,100,5,Mixed,2416,1828,4244
590380,100,8,Very Positive,13083,816,13899
617290,100,8,Very Positive,24039,3793,27832
476600,100,5,Mixed,12045,6745,18790
21000,100,8,Very Positive,5720,704,6424
633230,100,8,Very Positive,19402,3333,22735
458710,100,9,Overwhelmingly Positive,2342,122,2464
553420,100,8,Very Positive,9003,806,9809
692850,100,8,Very Positive,14711,1075,15786
287290,100,6,Mostly Positive,5877,1913,7790
707010,100,5,Mixed,2597,1331,3928
415200,100,8,Very Positive,5434,557,5991
253230,100,9,Overwhelmingly Positive,35781,739,36520
246420,100,9,Overwhelmingly Positive,5148,224,5372
1250,100,9,Overwhelmingly Positive,33471,1631,35102
339340,100,6,Mostly Positive,4126,1331,5457
237410,0,0,No user reviews,0,0,0
234330,90,5,Mixed,1705,972,2677
675010,100,8,Very Positive,10578,1070,11648
207140,100,8,Very Positive,15150,1030,16180
7940,100,8,Very Positive,11936,957,12893
681280,100,8,Very Positive,10494,591,11085
24790,100,8,Very Positive,3834,483,4317
243730,0,0,No user reviews,0,0,0
16810,100,8,Very Positive,841,141,982
562360,96,8,Very Positive,556,95,651
306020,100,8,Very Positive,7647,410,8057
357190,100,8,Very Positive,4184,361,4545
444480,5,5,Mixed,116,79,195
319630,100,9,Overwhelmingly Positive,70746,3407,74153
753,42,8,Very Positive,314,30,344
278080,100,8,Very Positive,3214,777,3991
560130,100,8,Very Positive,9527,1232,10759
616720,23,8,Very Positive,188,21,209
624090,100,5,Mixed,1573,824,2397
261570,100,9,Overwhelmingly Positive,14191,674,14865
427730,100,8,Very Positive,16565,3803,20368
252530,100,8,Very Positive,2842,590,3432
459220,100,8,Very Positive,5443,518,5961
285310,100,8,Very Positive,5454,296,5750
238460,100,9,Overwhelmingly Positive,29455,802,30257
489520,100,8,Very Positive,21440,2983,24423
291650,100,8,Very Positive,13351,1956,15307
332950,100,8,Very Positive,6304,813,7117
235900,100,8,Very Positive,1032,62,1094
613830,100,8,Very Positive,5920,785,6705
315210,100,5,Mixed,6057,3405,9462
282800,100,8,Very Positive,15176,1228,16404
304430,100,9,Overwhelmingly Positive,24254,986,25240
704270,100,6,Mostly Positive,18403,6817,25220
627270,100,8,Very Positive,7763,1348,9111
341800,100,9,Overwhelmingly Positive,9040,166,9206
611790,100,8,Very Positive,6105,826,6931
270150,100,8,Very Positive,5241,666,5907
24800,100,8,Very Positive,1546,346,1892
329050,100,8,Very Positive,5794,934,6728
108710,100,8,Very Positive,17002,2138,19140
536270,100,6,Mostly Positive,4768,1384,6152
632300,100,6,Mostly Positive,1966,496,2462
291480,100,5,Mixed,18206,11226,29432
667970,100,9,Overwhelmingly Positive,16606,323,16929
312530,100,9,Overwhelmingly Positive,16298,576,16874
571310,100,9,Overwhelmingly Positive,3886,198,4084
3620,100,8,Very Positive,1336,88,1424
541570,100,9,Overwhelmingly Positive,8413,229,8642
394510,100,8,Very Positive,11451,1166,12617
537180,100,5,Mixed,2500,1555,4055
488860,100,9,Overwhelmingly Positive,9278,300,9578
694280,100,8,Very Positive,2646,478,3124
307960,100,6,Mostly Positive,4464,1187,5651
200710,100,8,Very Positive,21842,1610,23452
491650,6,5,Mixed,37,38,75
201230,100,8,Very Positive,1903,464,2367
372000,100,5,Mixed,6068,4252,10320
573100,100,6,Mostly Positive,4491,1571,6062
300,100,8,Very Positive,9799,849,10648
683900,100,8,Very Positive,1712,184,1896
386070,100,8,Very Positive,8067,1344,9411
493490,100,6,Mostly Positive,4765,1705,6470
586350,80,8,Very Positive,220,22,242
438020,9,4,Mostly Negative,42,122,164
367450,100,8,Very Positive,5836,705,6541
705210,61,8,Very Positive,433,35,468
719040,100,8,Very Positive,11489,2050,13539
384180,100,8,Very Positive,3033,709,3742
225840,100,8,Very Positive,14032,987,15019
40100,100,8,Very Positive,6603,963,7566
544550,100,8,Very Positive,4016,680,4696
444640,100,8,Very Positive,19156,1981,21137
672680,100,5,Mixed,1345,748,2093
673750,100,8,Very Positive,1319,170,1489
232890,100,5,Mixed,3960,2000,5960
113200,100,8,Very Positive,28539,1577,30116
4580,100,9,Overwhelmingly Positive,5502,195,5697
222480,100,6,Mostly Positive,4205,1570,5775
528740,42,5,Mixed,281,198,479
307950,100,6,Mostly Positive,3801,1541,5342
567640,100,8,Very Positive,8102,1037,9139
482400,100,8,Very Positive,8067,762,8829
593600,100,5,Mixed,2654,1254,3908
468920,100,8,Very Positive,2363,293,2656
673610,99,8,Very Positive,3895,810,4705
383870,100,8,Very Positive,49587,6075,55662
539720,77,8,Very Positive,448,93,541
32510,100,8,Very Positive,4463,267,4730
600750,84,5,Mixed,655,341,996
330020,100,8,Very Positive,8104,1075,9179
606150,100,8,Very Positive,7353,1800,9153
403900,6,4,Mostly Negative,71,134,205
460950,100,9,Overwhelmingly Positive,24549,532,25081
476620,100,8,Very Positive,3488,827,4315
32430,100,6,Mostly Positive,4939,1805,6744
215080,100,5,Mixed,2641,1255,3896
629820,100,8,Very Positive,7400,861,8261
645630,100,8,Very Positive,20776,2251,23027
438480,100,8,Very Positive,603,143,746
319510,100,8,Very Positive,31188,2557,33745
333420,100,6,Mostly Positive,3087,880,3967
231350,100,8,Very Positive,121,7,128
712100,100,5,Mixed,5496,2452,7948
268050,100,6,Mostly Positive,8267,2228,10495
719640,35,5,Mixed,222,148,370
289130,100,8,Very Positive,9861,1744,11605
544750,100,8,Very Positive,6625,1376,8001
418030,100,6,Mostly Positive,5141,2173,7314
728530,100,8,Very Positive,2034,245,2279
342940,100,8,Very Positive,1954,333,2287
495910,100,5,Mixed,1958,1222,3180
402840,22,8,Very Positive,1376,310,1686
212160,100,5,Mixed,4556,2180,6736
553520,100,8,Very Positive,1211,292,1503
368340,100,8,Very Positive,10048,648,10696
410980,100,9,Overwhelmingly Positive,1159,45,1204
217200,100,8,Very Positive,4635,314,4949
451340,100,5,Mixed,5052,2252,7304
301120,27,8,Very Positive,863,132,995
666860,100,6,Mostly Positive,1162,383,1545
239820,100,8,Very Positive,23325,1324,24649
3990,34,8,Very Positive,321,28,349
396160,15,4,Mostly Negative,161,243,404
311560,99,8,Very Positive,5807,964,6771
666150,100,8,Very Positive,2496,339,2835
720620,100,8,Very Positive,3388,334,3722
399790,23,4,Mostly Negative,186,297,483
38400,100,8,Very Positive,13627,841,14468
647960,100,9,Overwhelmingly Positive,2826,86,2912
312450,100,6,Mostly Positive,1428,398,1826
645260,13,5,Mixed,176,76,252
56400,100,8,Very Positive,6288,640,6928
294420,15,8,Very Positive,125,14,139
611670,100,6,Mostly Positive,7000,2314,9314
375450,13,8,Very Positive,141,22,163
658850,100,8,Very Positive,2455,244,2699
304410,100,9,Overwhelmingly Positive,2766,66,2832
210970,100,8,Very Positive,8880,1931,10811
323470,100,8,Very Positive,7407,1158,8565
314650,100,9,Overwhelmingly Positive,7375,325,7700
352400,100,8,Very Positive,3722,444,4166
268400,100,8,Very Positive,1393,141,1534
678800,100,8,Very Positive,4105,712,4817
9480,100,6,Mostly Positive,9243,3157,12400
448510,100,8,Very Positive,5201,485,5686
403190,100,6,Mostly Positive,4602,1373,5975
420530,100,9,Overwhelmingly Positive,31023,524,31547
265550,100,6,Mostly Positive,6013,1992,8005
429050,100,6,Mostly Positive,9492,2375,11867
226840,100,6,Mostly Positive,5566,1411,6977
356500,100,8,Very Positive,2655,253,2908
38410,100,8,Very Positive,9241,561,9802
226860,87,6,Mostly Positive,6222,1836,8058
8980,100,8,Very Positive,16443,2188,18631
378120,100,6,Mostly Positive,1351,501,1852
213330,100,8,Very Positive,3672,225,3897
365960,100,6,Mostly Positive,3286,1048,4334
288470,100,8,Very Positive,7526,1317,8843
236430,100,8,Very Positive,18291,3029,21320
532210,100,8,Very Positive,12749,2289,15038
321960,100,5,Mixed,1340,1228,2568
2630,100,8,Very Positive,4388,336,4724
460790,100,8,Very Positive,10595,916,11511
285330,100,8,Very Positive,3621,387,4008
47780,100,8,Very Positive,11456,821,12277
55230,100,8,Very Positive,26563,1545,28108
39120,100,6,Mostly Positive,5321,1905,7226
280220,100,9,Overwhelmingly Positive,3616,125,3741
409720,100,5,Mixed,9302,4172,13474
288390,4,0,4 user reviews,4,0,4
42710,100,8,Very Positive,2302,251,2553
287980,100,9,Overwhelmingly Positive,8747,365,9112
531510,100,9,Overwhelmingly Positive,12607,345,12952
385770,60,8,Very Positive,2468,359,2827
601430,100,8,Very Positive,8163,788,8951
10190,100,8,Very Positive,5577,638,6215
404410,100,8,Very Positive,5642,410,6052
214510,100,8,Very Positive,6215,787,7002
238010,100,8,Very Positive,13994,1303,15297
362680,100,9,Overwhelmingly Positive,8282,297,8579
250320,100,9,Overwhelmingly Positive,20692,486,21178
331470,100,8,Very Positive,4488,517,5005
206420,100,8,Very Positive,26684,5000,31684
350080,100,8,Very Positive,9520,1168,10688
628050,7,7,Positive,36,7,43
610370,100,9,Overwhelmingly Positive,5172,248,5420
337000,100,6,Mostly Positive,16711,5826,22537
397350,100,9,Overwhelmingly Positive,1158,45,1203
248170,96,8,Very Positive,907,135,1042
524660,3,5,Mixed,25,15,40
302670,100,6,Mostly Positive,8868,2305,11173
388410,100,6,Mostly Positive,4468,1469,5937
477740,100,8,Very Positive,3604,201,3805
295270,100,6,Mostly Positive,1490,520,2010
429790,100,8,Very Positive,5314,1278,6592
641320,100,8,Very Positive,7629,1280,8909
48000,100,8,Very Positive,18160,1597,19757
377530,20,8,Very Positive,519,93,612
10150,100,6,Mostly Positive,3778,1242,5020
475550,100,8,Very Positive,3294,741,4035
447530,100,9,Overwhelmingly Positive,13443,459,13902
10680,100,8,Very Positive,9034,1004,10038
611500,100,6,Mostly Positive,13933,5727,19660
274520,100,8,Very Positive,9829,601,10430
3920,100,8,Very Positive,4979,303,5282
15370,100,8,Very Positive,846,81,927
15170,100,8,Very Positive,1123,190,1313
329430,100,6,Mostly Positive,4419,1260,5679
258970,100,6,Mostly Positive,5387,1364,6751
55150,100,8,Very Positive,17224,1617,18841
250520,100,8,Very Positive,4507,684,5191
700600,100,5,Mixed,5730,2773,8503
9880,100,5,Mixed,2096,936,3032
251150,100,8,Very Positive,6646,435,7081
99900,100,8,Very Positive,12077,2565,14642
550650,100,6,Mostly Positive,18138,7398,25536
366090,100,8,Very Positive,5622,511,6133
222880,100,8,Very Positive,48595,4262,52857
242680,100,9,Overwhelmingly Positive,11941,506,12447
460920,100,8,Very Positive,10481,1899,12380
24720,100,8,Very Positive,3683,370,4053
327400,78,9,Overwhelmingly Positive,630,26,656
3540,100,9,Overwhelmingly Positive,2186,80,2266
30,100,8,Very Positive,3109,318,3427
99910,100,8,Very Positive,1434,353,1787
374040,100,8,Very Positive,5155,1053,6208
509980,100,8,Very Positive,12242,2553,14795
470310,100,8,Very Positive,3012,212,3224
313690,100,8,Very Positive,3204,533,3737
6020,100,9,Overwhelmingly Positive,8112,368,8480
521890,100,6,Mostly Positive,6307,1956,8263
259680,100,9,Overwhelmingly Positive,4325,226,4551
39510,100,8,Very Positive,2703,343,3046
445980,100,8,Very Positive,8254,896,9150
441960,94,8,Very Positive,92,2,94
368070,100,5,Mixed,3860,1880,5740
444940,90,8,Very Positive,264,51,315
262410,100,8,Very Positive,6107,1435,7542
261030,100,9,Overwhelmingly Positive,14775,666,15441
282140,100,9,Overwhelmingly Positive,23804,1045,24849
578330,100,8,Very Positive,3983,458,4441
462780,100,8,Very Positive,4564,768,5332
410320,100,9,Overwhelmingly Positive,7536,346,7882
40800,100,8,Very Positive,16998,1020,18018
367670,41,8,Very Positive,1254,128,1382
320,100,8,Very Positive,6062,619,6681
348550,100,9,Overwhelmingly Positive,5240,163,5403
15100,100,6,Mostly Positive,8045,2123,10168
628890,1,5,Mixed,51,33,84
647830,100,8,Very Positive,2860,580,3440
447020,100,8,Very Positive,7136,566,7702
555160,100,8,Very Positive,29469,3371,32840
250760,100,9,Overwhelmingly Positive,11317,490,11807
15620,100,8,Very Positive,6391,924,7315
220440,100,8,Very Positive,9049,964,10013
563560,100,8,Very Positive,6012,381,6393
362620,100,8,Very Positive,5094,297,5391
351510,100,8,Very Positive,1587,134,1721
113400,100,5,Mixed,11859,7866,19725
6860,100,8,Very Positive,6738,401,7139
601840,100,8,Very Positive,5120,368,5488
515570,73,8,Very Positive,219,26,245
375480,100,8,Very Positive,3412,205,3617
532110,100,9,Overwhelmingly Positive,1780,86,1866
283640,100,8,Very Positive,6622,877,7499
575720,37,5,Mixed,353,404,757
4500,100,8,Very Positive,17631,1009,18640
231670,100,8,Very Positive,1546,172,1718
453090,100,8,Very Positive,5088,279,5367
605740,100,8,Very Positive,8659,1782,10441
427290,100,6,Mostly Positive,8106,2561,10667
29720,100,9,Overwhelmingly Positive,783,38,821
531640,73,6,Mostly Positive,3703,931,4634
334920,100,8,Very Positive,2743,175,2918
520440,100,9,Overwhelmingly Positive,6264,281,6545
8190,100,8,Very Positive,22171,1951,24122
405310,100,8,Very Positive,2243,441,2684
11020,100,8,Very Positive,10321,1034,11355
375950,100,8,Very Positive,5338,486,5824
50,100,9,Overwhelmingly Positive,13371,663,14034
503940,100,6,Mostly Positive,3687,951,4638
538030,100,8,Very Positive,1486,350,1836
201870,100,8,Very Positive,5054,1105,6159
222440,100,9,Overwhelmingly Positive,1202,44,1246
71250,100,8,Very Positive,10480,1009,11489
518150,100,8,Very Positive,4404,506,4910
558990,100,9,Overwhelmingly Positive,3600,110,3710
572890,100,9,Overwhelmingly Positive,4012,196,4208
334230,100,8,Very Positive,25046,3558,28604
680420,100,5,Mixed,25974,12038,38012
40960,100,8,Very Positive,2078,246,2324
690640,100,8,Very Positive,3305,246,3551
481510,100,8,Very Positive,13680,733,14413
582500,100,8,Very Positive,13684,1532,15216
43160,100,8,Very Positive,6022,456,6478
418240,100,8,Very Positive,10427,553,10980
448630,5,4,Mostly Negative,23,63,86
553790,8,8,Very Positive,99,17,116
238090,100,6,Mostly Positive,7170,2089,9259
257510,100,9,Overwhelmingly Positive,18038,809,18847
345260,99,6,Mostly Positive,1027,429,1456
242550,100,8,Very Positive,3445,554,3999
249050,100,8,Very Positive,7893,1395,9288
19900,100,6,Mostly Positive,7445,2041,9486
363090,4,7,Positive,15,3,18
602320,100,8,Very Positive,1350,162,1512
339610,100,6,Mostly Positive,4873,2048,6921
39150,100,8,Very Positive,4689,811,5500
393080,100,4,Mostly Negative,2809,4265,7074
298030,100,9,Overwhelmingly Positive,2407,85,2492
343780,100,8,Very Positive,6810,384,7194
541300,100,5,Mixed,1959,1102,3061
601050,100,8,Very Positive,3666,256,3922
326360,59,5,Mixed,214,151,365
718850,100,6,Mostly Positive,2964,766,3730
597220,100,9,Overwhelmingly Positive,8623,165,8788
644560,100,8,Very Positive,8031,783,8814
22490,100,8,Very Positive,2644,477,3121
252870,100,8,Very Positive,4280,480,4760
681820,3,7,Positive,35,4,39
20,100,8,Very Positive,4813,694,5507
276810,100,5,Mixed,3697,1687,5384
383180,100,5,Mixed,2790,1344,4134
677120,100,8,Very Positive,5192,661,5853
656350,100,8,Very Positive,3993,400,4393
674140,100,9,Overwhelmingly Positive,6097,140,6237
3310,100,8,Very Positive,1013,65,1078
366220,65,6,Mostly Positive,1657,691,2348
115320,100,5,Mixed,3803,1634,5437
50130,100,8,Very Positive,15035,1310,16345
373930,100,6,Mostly Positive,1570,461,2031
538680,100,8,Very Positive,3609,204,3813
550470,71,5,Mixed,408,250,658
4570,100,8,Very Positive,6717,397,7114
244160,100,8,Very Positive,7627,1134,8761
599390,100,8,Very Positive,2745,175,2920
251290,100,9,Overwhelmingly Positive,2827,63,2890
442120,100,8,Very Positive,2663,398,3061
363110,15,5,Mixed,10,5,15
3830,100,9,Overwhelmingly Positive,12560,637,13197
332800,100,8,Very Positive,13182,1009,14191
21130,100,8,Very Positive,3488,640,4128
352720,100,8,Very Positive,5011,1174,6185
206440,100,9,Overwhelmingly Positive,24826,1099,25925
274940,100,8,Very Positive,12370,1632,14002
288160,100,9,Overwhelmingly Positive,13616,373,13989
296490,100,9,Overwhelmingly Positive,2813,145,2958
699170,100,8,Very Positive,3710,484,4194
239350,100,8,Very Positive,10513,924,11437
7620,76,8,Very Positive,929,86,1015
259810,36,8,Very Positive,126,8,134
33930,100,8,Very Positive,10555,828,11383
394310,100,6,Mostly Positive,3501,1440,4941
246840,100,9,Overwhelmingly Positive,3400,151,3551
541210,100,8,Very Positive,3028,443,3471
397340,100,8,Very Positive,6941,514,7455
397460,100,9,Overwhelmingly Positive,1849,84,1933
269770,100,8,Very Positive,3812,522,4334
253250,100,6,Mostly Positive,5241,2176,7417
628060,12,6,Mostly Positive,52,19,71
3320,100,9,Overwhelmingly Positive,4510,117,4627
654890,100,6,Mostly Positive,1433,467,1900
688420,100,8,Very Positive,5396,405,5801
517790,100,8,Very Positive,1114,78,1192
200170,100,8,Very Positive,2960,586,3546
345240,84,8,Very Positive,648,98,746
432350,100,9,Overwhelmingly Positive,2863,30,2893
584400,100,8,Very Positive,14794,1143,15937
48720,100,8,Very Positive,3297,678,3975
673880,100,8,Very Positive,8980,767,9747
610180,100,9,Overwhelmingly Positive,2567,126,2693
203290,100,6,Mostly Positive,5042,1468,6510
290340,100,8,Very Positive,6798,1488,8286
71270,100,8,Very Positive,212,0,212
226320,100,6,Mostly Positive,6070,2349,8419
501300,100,8,Very Positive,16390,981,17371
378760,100,6,Mostly Positive,932,320,1252
2600,100,8,Very Positive,10025,530,10555
677620,100,8,Very Positive,80767,7457,88224
265930,100,8,Very Positive,35669,3621,39290
6910,99,9,Overwhelmingly Positive,10729,531,11260
215100,100,5,Mixed,999,473,1472
341940,100,8,Very Positive,8448,1975,10423
375910,100,5,Mixed,2033,911,2944
672870,53,8,Very Positive,225,54,279
528230,100,8,Very Positive,9492,511,10003
564230,100,8,Very Positive,2274,245,2519
17470,100,8,Very Positive,13316,1434,14750
701470,62,8,Very Positive,141,25,166
4560,100,8,Very Positive,3792,230,4022
688470,4,6,Mostly Positive,50,19,69
324800,100,8,Very Positive,8771,1298,10069
323850,100,8,Very Positive,3970,723,4693
209160,100,5,Mixed,7536,5380,12916
679900,100,8,Very Positive,2462,197,2659
217490,0,0,No user reviews,0,0,0
4920,100,8,Very Positive,7321,1251,8572
653530,100,9,Overwhelmingly Positive,17260,593,17853
555570,100,5,Mixed,4963,5855,10818
311340,100,8,Very Positive,8070,1591,9661
214730,74,8,Very Positive,1089,141,1230
2320,100,9,Overwhelmingly Positive,5839,286,6125
628080,4,6,Mostly Positive,17,7,24
369990,99,8,Very Positive,1376,306,1682
473690,100,6,Mostly Positive,6705,2602,9307
204450,100,8,Very Positive,16192,929,17121
537800,99,8,Very Positive,7338,1085,8423
239160,100,5,Mixed,6904,3423,10327
607080,100,9,Overwhelmingly Positive,9077,291,9368
437920,100,8,Very Positive,3168,402,3570
312750,100,8,Very Positive,1605,315,1920
311770,100,8,Very Positive,1963,251,2214
204300,100,8,Very Positive,12700,2517,15217
496300,100,8,Very Positive,4256,860,5116
21090,100,8,Very Positive,9389,659,10048
2310,100,9,Overwhelmingly Positive,10398,378,10776
434650,62,6,Mostly Positive,1520,466,1986
212480,100,8,Very Positive,9374,702,10076
684450,100,5,Mixed,1745,749,2494
457550,96,8,Very Positive,2119,389,2508
567630,62,6,Mostly Positive,1422,434,1856
384300,100,6,Mostly Positive,2202,767,2969
604500,91,5,Mixed,547,284,831
396750,100,6,Mostly Positive,4701,1247,5948
426000,100,8,Very Positive,4527,613,5140
45740,100,6,Mostly Positive,3520,1046,4566
456750,100,9,Overwhelmingly Positive,5522,244,5766
227320,11,8,Very Positive,1122,101,1223
16700,88,8,Very Positive,452,26,478
301320,100,9,Overwhelmingly Positive,1095,35,1130
612020,27,8,Very Positive,681,136,817
7600,100,6,Mostly Positive,1615,663,2278
586200,100,5,Mixed,1219,577,1796
32330,100,8,Very Positive,1937,285,2222
476460,94,8,Very Positive,1197,80,1277
248570,100,8,Very Positive,9299,1105,10404
285190,100,5,Mixed,5406,6585,11991
377300,100,5,Mixed,1384,616,2000
455130,0,0,No user reviews,0,0,0
18500,100,9,Overwhelmingly Positive,3768,144,3912
315660,64,6,Mostly Positive,1413,394,1807
441550,90,8,Very Positive,861,123,984
302510,100,8,Very Positive,12775,2401,15176
423580,100,8,Very Positive,2248,446,2694
294860,100,8,Very Positive,7789,895,8684
